###################
#........#........#
#O##.###.#.###.##O#
#.................#
#.##.#.#####.#.##.#
#....#...#...#....#
####.###.#.###.####
   #.#.......#.#
####.#.#####.#.####
S......#   #......S
S......#   #......S
####.#.#####.#.####
   #.#.......#.#
####.#.#####.#.####
#........#........#
#.##.###.#.###.##.#
#O.#...........#.O#
##.#.#.#####.#.#.##
#....#...#...#....#
#.######.#.######.#
#.................#
###################